111111111111111111
100000000000000001
100000000000000001
1000000000000E0001
10001000000C000001
101000000010000001
100000000000000001
100C01P10000110001
111111111111111111
